             |      |
             |      |
             |      |
             |      |
             |      |
             |      |
             *-*+*--*
               |+|
               | |
               |+|
               | |
               |+|
               | |
               |+|
               | |
               |+|
               | |
               |+|
               | |
               |+|
               | |
               |+|
               | |
               |+|
               | |
               |+*
               *  \
                \ +\
                 *  *
                 |+ |
                 *  *
                /  /
               * +*
               |+ |
               | +|
               |+ |
               | +|
               |+ |
               | +|
               |+ |
               | +|
               |+ |
               | +|
               |+ |
               | +|
               |+ |
               | +|
               |+ |
               | +|
               |+ |
               | +|
               *+ *
              /+ + \
             *+ + + *
             | + + +|
             |+ + + |
             | + + +|
             |+ + + |
             | + + +|
             |+ + + |
             | + + +|
             |+ + + |
             | + + +|
             |+ + + |
             | + + +|
             |+ + + |
             | + + +|
             |+ + + |
             |      |
             |+     |
             |      |
             |+     |
             | *----*
             |+|
             | *----*
             |+     |
             |      |
             |+     |
             | *----*
             |+|
             | *----*
             |+     |
             |      |
             |+     |
             | *----*
             |+|
             | *----*
             |+     |
             |      |
             |      |
             |      |
             |      |
             |     +|
             *----* |
                  |+|
             *----* |
             |     +|
             |      |
             |     +|
             *----* |
                  |+|
             *----* |
             |     +|
             |      |
             |     +|
             *----* |
                  |+|
             *----* |
             |      |
             |      |
             |      |
             *-*+ *-*
               | +|
             *-*+ *-*
             |      |
             |      |
             |      |
             |+*----*
             | |
             |+*----*
             |      |
             |      |
             *-* *--*
               |+|
             *-* *--*
             |      |
             |      |
             |      |
             *-* +*-*
               |+ |
             *-* +*-*
             |      |
             |      |
             |      |
             *--*+*-*
                | |
             *--*+*-*
             |      |
             |      |
             |      |
             *----*+|
                  | |
             *----*+|
             |      |
             |      |
             |      |
             *-* +*-*
               |+ |
             *-* +*-*
             |      |
             |      |
             |      |
             |+*----*
             | |
             |+*
             |  \
             |   *--*
             |      |
             |      |
             |      |
             *----*+|
                  | |
                  *+|
                 /  |
             *--*   |
             |      |
             |      |
             |      |
             |+*----*
             | |
             |+*
             |  \
             |   *--*
             |      |
             |      |
             |      |
             *----*+|
                  | |
                  *+|
                 /  |
             *--*   |
             |      |
             |      |
             |      |
             | +*---*
             |  |
             | +*---*
             |      |
             |      |
             |      |
             *---* +|
                 |+ |
             *---* +|
             |      |
             |      |
             |      |
             |+ +*--*
             | + |
             |+ +*--*
             |      |
             |      |
             |      |
             *--* + |
                |+ +|
             *--* + |
             |      |
             |      |
             |      |
             |+ + *-*
             | + +|
             |+ + *-*
             |      |
             |      |
             |      |
             *-*+ + |
               | + +|
             *-*+ + |
             | + + +|
             |+ + + |
             | + + +|
             |+ + + |
             | + + +|
             |+ + + |
             | + + +|
             |+ + + |
             | + + +|
             |+ + + |
             | + + +|
             |+ + + |
             | + + +|
             |+ + + |
             | + + +|
             |+ + + |
             |      |
             |      |
             |      |
             |      |
             |      |
             |      |
             |      |
             |      |
